ARMA_MAT_TXT_FN008
71 4
   0.000000000000e+00  -2.123411730833e+00   0.000000000000e+00   0.000000000000e+00
   1.044918298721e-01   2.417689085007e+00   1.000000000000e+00   1.360000000000e+01
   1.031671166420e-01  -2.169261217117e+00   2.000000000000e+00   1.380000000000e+01
   1.024740189314e-01   2.389450311661e+00   3.000000000000e+00   1.400000000000e+01
   1.022091135383e-01  -2.181157588959e+00   4.000000000000e+00   1.420000000000e+01
   1.022683605552e-01   2.392173767090e+00   5.000000000000e+00   1.440000000000e+01
   1.026189029217e-01  -2.165763378143e+00   6.000000000000e+00   1.460000000000e+01
   1.032721102238e-01   2.418167829514e+00   7.000000000000e+00   1.480000000000e+01
   1.042608767748e-01  -2.131288766861e+00   8.000000000000e+00   1.500000000000e+01
   1.056203916669e-01   2.458986282349e+00   9.000000000000e+00   1.520000000000e+01
   1.073741838336e-01  -2.086215257645e+00   1.000000000000e+01   1.540000000000e+01
   1.095255538821e-01   2.506364345551e+00   1.100000000000e+01   1.560000000000e+01
   1.120531484485e-01  -2.038276672363e+00   1.200000000000e+01   1.580000000000e+01
   1.149108186364e-01   2.553385257721e+00   1.300000000000e+01   1.600000000000e+01
   1.180309504271e-01  -1.993346691132e+00   1.400000000000e+01   1.620000000000e+01
   1.213298216462e-01   2.595356941223e+00   1.500000000000e+01   1.640000000000e+01
   1.247130110860e-01  -1.954929113388e+00   1.600000000000e+01   1.660000000000e+01
   1.280811280012e-01   2.629853248596e+00   1.700000000000e+01   1.680000000000e+01
   1.313340663910e-01  -1.924552083015e+00   1.800000000000e+01   1.700000000000e+01
   1.343754678965e-01   2.656037807465e+00   1.900000000000e+01   1.720000000000e+01
   1.371155381203e-01  -1.902556180954e+00   2.000000000000e+01   1.740000000000e+01
   1.394724994898e-01   2.673882961273e+00   2.100000000000e+01   1.760000000000e+01
   1.413750350475e-01  -1.888811588287e+00   2.200000000000e+01   1.780000000000e+01
   1.427624225616e-01   2.683560848236e+00   2.300000000000e+01   1.800000000000e+01
   1.435861140490e-01  -1.883196830750e+00   2.400000000000e+01   1.820000000000e+01
   1.438098102808e-01   2.685069322586e+00   2.500000000000e+01   1.840000000000e+01
   1.434103399515e-01  -1.885895490646e+00   2.600000000000e+01   1.860000000000e+01
   1.423786282539e-01   2.677995681763e+00   2.700000000000e+01   1.880000000000e+01
   1.407198011875e-01  -1.897594571114e+00   2.800000000000e+01   1.900000000000e+01
   1.384552866220e-01   2.661334991455e+00   2.900000000000e+01   1.920000000000e+01
   1.356234103441e-01  -1.919655561447e+00   3.000000000000e+01   1.940000000000e+01
   1.322812736034e-01   2.633326053619e+00   3.100000000000e+01   1.960000000000e+01
   1.285069584846e-01  -1.954272270203e+00   3.200000000000e+01   1.980000000000e+01
   1.244017481804e-01   2.591335058212e+00   3.300000000000e+01   2.000000000000e+01
   1.200926676393e-01  -2.004485845566e+00   3.400000000000e+01   2.020000000000e+01
   1.157346814871e-01   2.532033205032e+00   3.500000000000e+01   2.040000000000e+01
   1.115112006664e-01  -2.073652267456e+00   3.600000000000e+01   2.060000000000e+01
   1.076320856810e-01   2.452503442764e+00   3.700000000000e+01   2.080000000000e+01
   1.043260246515e-01  -2.163515090942e+00   3.800000000000e+01   2.100000000000e+01
   1.018255501986e-01   2.353162288666e+00   3.900000000000e+01   2.120000000000e+01
   1.003431230783e-01  -2.270428657532e+00   4.000000000000e+01   2.140000000000e+01
   1.000413149595e-01   2.241656541824e+00   4.100000000000e+01   2.160000000000e+01
   1.010040566325e-01  -2.382781982422e+00   4.200000000000e+01   2.180000000000e+01
   1.032191142440e-01   2.132375955582e+00   4.300000000000e+01   2.200000000000e+01
   1.065781787038e-01  -2.485556125641e+00   4.400000000000e+01   2.220000000000e+01
   1.108935549855e-01   2.038595199585e+00   4.500000000000e+01   2.240000000000e+01
   1.159237250686e-01  -2.568934679031e+00   4.600000000000e+01   2.260000000000e+01
   1.213985159993e-01   1.966101408005e+00   4.700000000000e+01   2.280000000000e+01
   1.270384937525e-01  -2.630703449249e+00   4.800000000000e+01   2.300000000000e+01
   1.325670927763e-01   1.914546608925e+00   4.900000000000e+01   2.320000000000e+01
   1.377169340849e-01  -2.672671794891e+00   5.000000000000e+01   2.340000000000e+01
   1.422325670719e-01   1.881585359573e+00   5.100000000000e+01   2.360000000000e+01
   1.458715796471e-01  -2.697044849396e+00   5.200000000000e+01   2.380000000000e+01
   1.484057158232e-01   1.865625619888e+00   5.300000000000e+01   2.400000000000e+01
   1.496227085590e-01  -2.704437494278e+00   5.400000000000e+01   2.420000000000e+01
   1.493315547705e-01   1.867378950119e+00   5.500000000000e+01   2.440000000000e+01
   1.473716646433e-01  -2.692380428314e+00   5.600000000000e+01   2.460000000000e+01
   1.436295807362e-01   1.891722679138e+00   5.700000000000e+01   2.480000000000e+01
   1.380704194307e-01  -2.652547597885e+00   5.800000000000e+01   2.500000000000e+01
   1.307956576347e-01   1.952095270157e+00   5.900000000000e+01   2.520000000000e+01
   1.221504732966e-01  -2.563815116882e+00   6.000000000000e+01   2.540000000000e+01
   1.129235401750e-01   2.080706596375e+00   6.100000000000e+01   2.560000000000e+01
   1.046806797385e-01  -2.380876302719e+00   6.200000000000e+01   2.580000000000e+01
   1.001427993178e-01   2.327471256256e+00   6.300000000000e+01   2.600000000000e+01
   1.029957532883e-01  -2.085694074631e+00   6.400000000000e+01   2.620000000000e+01
   1.162965670228e-01   2.621473789215e+00   6.500000000000e+01   2.640000000000e+01
   1.407867521048e-01  -1.840593695641e+00   6.600000000000e+01   2.660000000000e+01
   1.754583269358e-01   2.804962158203e+00   6.700000000000e+01   2.680000000000e+01
   2.190726250410e-01  -1.708189249039e+00   6.800000000000e+01   2.700000000000e+01
   2.708152830601e-01   2.900777816772e+00   6.900000000000e+01   2.720000000000e+01
   3.302983939648e-01  -1.637565135956e+00   7.000000000000e+01   2.740000000000e+01
